aa = Afar / Afar
ab = Abkhazian / Abkhazian
af = Afrikaans / Afrikaans
ag = AngloSaxon / Anglo-Saxon
ak = Akana / Akan
am = Amharic / Amharic
an = Aragonés / Aragonese
ar = العربية / Arabic
as = Assamese / Assamese
at = Asturianu / Asturian
av = Авар / Avar
ay = Aymar / Aymara
az = Azərbaycan / Azeri
ba = Башҡорт / Bashkir
bal = بلوچی / Balochi
be = Беларуская / Belarusian
bg = Български / Bulgarian
bgc = हरियाणवी / Haryanvi
bh = भोजपुरी / Bihari
bho = भोजपुरी / Bhojpuri
bi = Bislama / Bislama
bm = Bamanankan / Bambara
bn = Bengali / Bengali
bo = Bodskad / Tibetan
br = Brezhoneg / Breton
bs = Bosanski / Bosnian
ca = Català / Catalan
cb = Kaszëbsczi / Kashubian
cdo = 閩東語 / Min Dong
ce = Cherokee / Cherokee
ceb = Binisaya / Cebuano/Binisaya
ch = Chamoru / Chamorro
co = Corsu / Corsican
cr = Nehiyaw / Cree
cs = Čeština / Czech
ctg = টগাঁইয়াবুলি / Chittagonian
cy = Cymraeg / Welsh
da = Dansk / Danish
dcc = دکنی‎ / Dakhini
de = Deutsch / German
dv = Divehi / Dhivehi
dz = Dzongkha / Dzongkha
el = Ελληνικά / Greek
en = English / English
eo = Esperanto / Esperanto
es = Español / Spanish
et = Eesti / Estonian
eu = Euskara / Basque
fa = فارسی / Persian
fi = Suomi / Finnish
fj = Na Vosa Vakaviti / Fijian
fo = Føroyskt / Faroese
foi = Foi / Foe
fr = Français / French
ful = Fula / Fula
fy = Frysk / WestFrisian
ga = Gaeilge / Irish
gan = 贛語 / Gan
gd = Gàidhlig / Scottish Gaelic
gl = Galego / Galician
gn = Avañe'ẽ / Guarani
gu = ગુજરાતી / Gujarati
gv = Gaelg / Manx
ha = هَوُسَ / Hausa
hak = 客家 / Hakka
han = 湖南话 / Xiang
hat = Kreyòlayisyen / Haitian Creole
he = עברית / Hebrew
hi = हिन्दी / Hindi
hm = Hmong / Hmong
hne = छत्तीसगढ़ी / Chhattisgarhi
hr = Hrvatski / Croatian
hru = Hruso / Hruso
hu = Magyar / Hungarian
huh = Huilliche / Huilliche
hy = Հայերեն / Armenian
ia = Interlingua / Interlingua
ibo = Igbo / Igbo
id = BahasaIndonesia / Indonesian
ie = Interlingue / Interlingue
ik = Iñupiak / Inupiak
ilo = Ilokano / Ilokano
io = Ido / Ido
is = Íslenska / Icelandic
it = Italiano / Italian
iu = Inuktitut / Inuktitut
ja = 日本語 / Japanese
jb = Lojban / Lojban
jv = Basa Jawa / Javanese
ka = ქართული / Georgian
kim = тоъфá / Tofa
kin = Ikinyarwanda / Kinyarwanda
kk = қазақша / Kazakh
kl = Kalaallisut / Greenlandic
km = Khmer / Khmer
kn = ಕನ್ನಡ / Kannada
ko = 한국어 / Korean
kok = कोंकणी / Konkani
ks = कश्मीरी-(كشميري / Kashmiri
ku = Kurdî/كوردی / Kurdish
kw = Kernewek/Karnuack / Cornish
ky = Kırgızca / Kirghiz
la = Latina / Latin
lb = Lëtzebuergesch / Luxembourgish
li = Limburgs / Limburgian
ln = Lingala / Lingala
lo = Lao / Lao
lol = lolspeak / lolspeak
lt = Lietuvių / Lithuanian
lv = Latviešu / Latvian
mad = بَهاسَمَدورا / Madurese
mai = मैथिली / Maithili
mg = Malagasy / Malagasy
mh = Ebon / Marshallese
mi = Māori / Maori
mk = Македонски / Macedonian
mkj = Mokilese / Mokilese
ml = Malayalam / Malayalam
mn = Монгол / Mongolian
mne = црногорски / Montenegrin
mnp = 闽北语 / Min Bei
mo = Moldoveana / Moldovan
mos = Mòoré / Mossi
mr = मराठी / Marathi
ms = Bahasa Melayu / Malay
mt = bil-Malti / Maltese
mu = Karaoke / Karaoke
mwr = मारवाड़ी / Marwari
my = Myanmasa / Burmese
na = dorerin Naoero / Nauruan
nd = Plattdüütsch / Low Saxon
ne = नेपाली / Nepali
nh = Nahuatl / Nahuatl
nl = Nederlands / Dutch
nn = Nynorsk / Norwegian (Nynorsk)
no = Norsk(Bokmål) / Norwegian (Bokmål)
nya = Nyanja / Chewa/Nyanja
oc = Occitan / Occitan
om = Oromoo / Oromo
or = Oriya / Oriya
pa = ਪੰਜਾਬੀ / Punjabi
pi = पािऴ / Pali
pl = Polski / Polish
ps = پښتو / Pashto
pt = Português / Portuguese
qu = Runa Simi / Quechua
ra = Armãneashce / Aromanian
rm = Rumantsch / Raeto Romance
rn = Kirundi / Kirundi
ro = Română / Romanian
ru = Русский / Russian
sa = संस्कृतम् / Sanskrit
sat = Santhali / Santhali
sb = Sicilianu / Sicilian
sc = Sardu / Sardinian
sd = سنڌي / Sindhi
sg = Sängö / Sango
sh = Srpskohrvatski / Serbo-Croatian
si = Sinhalese / Sinhalese
sk = Slovenčina / Slovak
skr = سرائیکی / Saraiki
sl = Slovenščina / Slovenian
sm = Gagana Samoa / Samoan
sn = chi Shona / Shona
so = Soomaaliga / Somali
sq = Shqip / Albanian
sr = Српски/Srpski / Serbian
ss = Si Swati / Swati
st = Sesotho / Southern Sotho
su = Basa Sunda / Sundanese
sv = Svenska / Swedish
sw = Kiswahili / Swahili
syl = ছিলটী / Sylheti
ta = தமிழ் / Tamil
te = తెలుగు / Telugu
tg = Тоҷикӣ / Tajik
th = ไทย / Thai
ti = Tigrinya / Tigrinya
tk = تركمن/Туркмен / Turkmen
tl = Tagalog / Tagalog
tm = tlh Ingan-Hol / Klingon
tn = Setswana / Setswana
to = Faka Tonga / Tongan
tp = Tok Pisin / Tok Pisin
tq = Tokipona / Tokipona
tr = Türkçe / Turkish
ts = Xitsonga / Tsonga
tt = Tatarça/Татарча / Tatar
tw = Twi / Twi
tzx = Yokoim / Yokoim
udm = УдмуртЭлькун / Udmurt
ug = Oyghurque / Uyghur
uk = Українська / Ukrainian
ur = اڙدو / Urdu
uz = O‘zbek / Uzbek
vi = TiếngViệt / Vietnamese
vo = Volapük / Volapük
wa = Walon / Walloon
wnw = Winnemem Wintu / Winnemem Wintu
wo = Wollof / Wolof
xal = Kalmyk / Kalmyk
xh = isiXhosa / Xhosan
yi = ייִדיש / Yiddish
yo = Yorùbá / Yoruba
yue = 粵語 / Cantonese
za = Cuengh / Zhuang
zh = 简体中文 / Chinese(Simplified)
zm = Bân-lâm-gú / Min Nan
zom = Zomi / Zomi
zt = 繁體中文 / Chinese(Traditional)
zu = isiZulu / Zulu